0000000000
0000000bb0
0000000bt0
0000000bbb
00s0000000
0000000000
0000000000